   h          hh S                         t 
 w h  p    p  hhmS              p          S 
 u h          hhSS          p              Sc
h  h          hh                           hh
              hh                  SS         
                                             
 p                                           
t t t t t t t t t t t t t t t t t t t t t t  
            p         p p   t             h  
 p          h               t       p     h  
       t    h               S                
        t               S   S       hhh      
         t              S   S        rh      
          t             S             h      
           t            S                    
  t t t t t t t t t t t t t t t t t t t t t t
  S p                                        
  S                  p                     p 
                   t            h            
                   t            h            
                   t            h       h  hh
tttSS                    p              h    
 m SS      p               m            h  w 
c rSS                                   h    