   h          hh S                         t 
 w h  p    p  hhmS       2      p    Q     S 
   h          hhSS          p              Sc
h  h          hh      k                    hh
            b hh                  SS         
  s               b                     2    
 p  k        s                               
t t t t t t t t t t t t t t t t t t t t t t  
            p         p p   t             h  
 p  Q  s    p     2         t   b   p     h  
       t    h               S                
        t   h           S k S       hhh      
         t          Q   S   S        rh      
   b      t             S           k h      
           t            S                    
  t t t t t t t t t t t t t t t t t t t t t t
  S p                                        
  S      2           p   k                 p
                   t            h       k    
                   t  k   b     h            
                   t            h   b   h  hh
tttSS    Q               p              h 2  
 m SS      p           k   m         Q  h  w 
c rSS                                   h    
